        111111111111111111111111100000000000010000000000001
        101100000111000000000000100000000000010000000000001
        100100000000000000000000100000000000010000000000001
11111111101100000111000000000000100000000000010000000000001
10000000001100000111011111011111100000000000010000000000001
1111011111111101110000001000100000000000010000000000001
1111011111111101110101001000100000000000010000000000001
11000000110101011100000010001
1000000000000000110000001000100000000000010000000000001
1000000000000000110101001000100000000000010000000000001
1100000111010101111101111000111
11110111 1110101 10111101000100000000000010000000000001
11111111 1111111 11111111111100000000000010000000000001
        1000000000110000000000001
        1011000001110000000000001
        1001000000000000000000001111111111111111111111111
111111111011000001110000000N0000100000000000010000000000001
10000000001100000111011111011111100000000000010000000000001
11110111111111011100000010001111111111111111111111111
11110111111111011101010010001
1100000011010101110000001000100000000000010000000000001
10000000000000001100000010001
10000000000000001101010010001
1100000111010101111101111000111
11110111 1110101 101111010001
11111111 1111111 111111111111
        1000000000110000000000001111111111111111111111111
        101100000111000000000000100000000000010000000000001
        100100000000000000000000100000000000010000000000001
111111111011000001110000000000001111111111111111111111111
100000000011000001110111110111111
11110111111111011100000010001
11110111111111011101010010001
11000000110101011100000010001111111111111111111111111
1000000000000000110000001000111111111111111111111111111111111111111111111111111111
110000011101010111110111100011111111111111111111111111111111111111111111111111111
11110111 1110101 101111111111111111111111111100000000111111111111111111111111111
11111111 1111111 111111111111111111111111111111111111111111111111
                             11111111111111111111111111
