
NO ./path_to_the_north_texture
SO        ./path_to_the_south_texture
F 220,100,0
C 225,30,0
WE ./path_to_the_west_texture
EA ./path_to_the_east_texture


	    11111111
        1N00000111111111111111111
        1011000001110000000000001
        1001000000000000000000001
111111111011000001110000000000001
100000000011000001110111110111111
11110111111111011100000000001
11110111111111011101010010001
11000000110101011100000010001
11111111111111111111111111111
