
NO ./textures/north.png
SO ./textures/south.png
WE ./textures/west.png
EA ./textures/east.png

C 0,10,205
F 6,84,43




        11111111
        1000000111111111111111111
        1011000001110000000000001
        10010000000000000000W0001
111111111011000001110000000000001
100000000011000001110111110111111
11110111111111011100000000001
11110011111111011101010010001
11000000110101011100000010001
11111111111111111111111111111
