
NO ./textures/no_wall.png
SO ./textures/so_wall.png
WE ./textures/we_wall.png
EA ./textures/ea_wall.png
C 0,0,255
F 6,64,43




        11111111
        1000000111111111111111111
        1011000001110000000000001
        10010000000000W0000000001
111111111011000001110000000000001
100000000011000001110111110111111
11110111111111011100000000001
11110111111111011101010010001
11000000110101011100000010001
11111111111111111111111111111
