NO ./textures/wall_1.png
SO ./textures/wall_2.png
WE ./textures/wall_4.png
EA ./textures/wall_6.png
F 5,78,22
C 45,201,212

        1111111111111111111111111
        1000000000110000000000001
        1011000001110000000000001
        100100000000000000W000001
111111111011000001110000000000001
100000000011000001110111111111111
11110111111111011100000010001
11110111111111011101010010001
11000000110101011100000010001
10000000000000001100000010001
100000000    0001101010010001
11000001110101011111   000111
11110111 1110101 10    010001
11111111 1111111 111111111111